1111110
10000p1
1000001
1111111
